.....#############.....
####/.............\####
.......................
.......................
.......................
...........@...........
.......................
.......................
.......................
####].............[####
.....#############.....